111111111111111111111111111111111
1P100000000000C111111110000001111
101C01C00000011110000000G11C00111
101111111000011000000000011111111
1000000000000000000G0000000C01111
111111111111111111000000111111111
10100000000000C111111110000001111
101C01C00000011110000000G11C00111
101111111000011000000000011111111
1000000000000000000G0000000C01111
101C01C00000011110000000G11C00111
101111111000011000000000011111111
1000000000000000000G0000000C01111
101C01C00000011110000000G11C00111
1000000000000000000G0000000C01111
101C01C00000011110000000G11C00111
1000000000000000000G0000000C01111
101C01C00000011110000000G11C00111
111111111111111111E00000011111111
111111111111111111111111111111111